F 220,100,0
C 225,30,0

NO ./textures/1etusfinal.png


SO ./textures/1etusfinal.png



WE ./textures/P.png



EA ./textures/P.png

00000

11111
10001
10N01
10001
11111
