F 0,255,0
C 225,30,0

NO ./textures/1x2.png


SO ./textures/2x2.png



WE ./textures/100x1.png



EA ./textures/P.png

 00000


111111
100011
10N011
100011
111111
