NO textures/brick.xpm
SO textures/brick.xpm
WE textures/brick.xpm
EA textures/brick.xpm
S ./textures/brick.xpm
F 22 ,10 ,8
C 225,30,0
R 852 480
1111111111111111111111111
1011111111111111111111111
1111111111111111111111111
1111111111111111111111111
1111111111111111111111111
1111111111111111111111111
1111111111111111111111111
1111111111111111111111111
111111E100110000000000001
1011011101110000000000011
100100000000000000000000111111111
111111111011000001110000000000001
100000000011000001110111111111111
11110111111111011100000010001
11110111111111011101010010001
11000000110101011100000010001
1000 000000000001100000010001
10000000000000011010100100011
1100000111010101111101111000111
11110111 1110101 101111010001
1111 111111111111111111111111
